111111111111111111111
1P000000000000000C1C1
111011101110111010101
101010000010101010001
101010111110101111101
101010001000000010101
101110111011111010101
100000001010100010001
101111101110101011101
100010001010001010001
101111101011101011101
101010000010001010101
101011111011111010111
1010100C00100010000C1
101011101010111011111
1C10100C10100000001E1
111010111111101010101
100000101000001010101
101111101010101110001
100000100010101000001
111111111111111111111
