111111111111111111111111111
1P00000000000000000000000C1
100000000000000000000000001
100000000000000000000000001
100000000000000000001000001
10000000000000C000001000001
11111111110000000000100X001
1000000000X0000000001000001
1C00000000000000000010000E1
111111111111111111111111111
