111111111
1C0C000C1
1000P0001
1C000C0E1
111111111
