1111
1PC1
1111
1E11
1111
1111
1111
